................
.##############.
.#            #.
.#            #.
.#            #.
.              .
.              .
.      ..      .
.      ..      .
.              .
.              .
.              .
.#            #.
.#            #.
.##############.
................