#  ##  ##  ##  #
# ##  ##    ## #
# #  ###### ## #
# #  ##  #  ## #
#           ## #
####    ###   ##

#  ##  ##  ##  #
# ##  ##    ## #
# #  ###### ## #
# #  ##  #  ## #
#   ##      ## #
#####   ###   ##

################
################