^..............^
.##############.
.#            #.
.#            #.
.#            #.
.              .
.              .
.      &&      .
.      &&      .
.              .
.              .
.              .
.#            #.
.#            #.
.##############.
^..............^