^.............#.
.###    #     #.
.#.#.##...##^ #.
.#&#..........#.
.#...##########.
. #     ...   ^.
. #.   ...   ...
. #...     ####.
. ####     #^&#.
..  &#  ...#..#.
.#. .#     #   .
.#. .#..      #.
.#. .#   ###^.#.
.#. .    #......
#######. #######
&.......  .....^